5 5 5 5 5 5 5 5 5 5 5 0 0 0 0 0 0 0 0 0
5 5 5 5 5 5 5 5 5 5 5 0 0 0 0 0 0 0 0 0
5 5 5 5 5 5 5 5 5 5 5 0 0 0 0 0 0 0 0 0
5 5 5 5 5 5 5 5 5 5 5 0 0 0 0 0 0 0 0 0
5 5 5 5 5 5 5 5 5 5 5 0 0 0 0 0 0 0 0 0
5 5 5 5 5 5 5 5 5 5 5 0 0 0 0 0 0 0 0 0
0 8 8 8 0 0 0 0 0 0 0 0 0 0 0 0 0 0 0 0
0 8 8 8 0 0 0 0 0 5 9 0 0 5 0 0 0 0 0 0
1 1 0 0 0 0 0 0 0 5 0 0 0 5 0 0 0 0 0 0
1 1 0 0 0 5 0 0 0 5 0 0 0 5 0 0 0 0 0 0
1 1 0 0 0 5 7 8 8 5 0 0 0 0 0 0 0 0 0 0
1 1 0 0 0 5 8 8 8 5 0 0 0 0 0 0 0 0 0 0
1 1 0 0 0 5 8 8 8 5 0 0 0 0 0 0 0 0 0 0
1 1 0 0 0 0 0 0 0 0 0 0 0 0 0 0 0 0 0 0
1 1 1 1 1 1 1 1 1 1 1 0 0 0 0 0 0 0 0 0
1 1 1 1 1 1 1 1 1 1 1 0 0 0 0 0 0 0 0 0 


